申明:本书由久久小说下载网(www.txt99.com)自网络收集整理制作,仅供预览交流学习使用,版权归原作者和出版社所有,如果喜欢,请支持订阅购买正版.


     [英语六级词汇 / 未知 著 ]
 
    书籍介绍:
    英语六级词汇


 ------章节内容开始-------

    第一卷 第一章
更新时间:2006-7-22 10:22:00 本章字数:22062

?marvel=n.奇迹；惊奇  vt.惊奇
masculine=a.男性的；强壮的
massacre=n.大屠杀，残杀
massive=a.粗大的；大而重的
mast=n.桅杆；杆  vt.扯帆
mature=vt.使成熟  vi.成熟
measurement=n.(量得的)尺寸，大小
mechanics=n.力学，机械学；结构
mechanism=n.机械装置；机制
meditate=vt.沉思，冥想，反省
melancholy=n.&a.忧郁(的)，悲伤
melody=n.旋律，曲调；歌曲
membership=n.成员资格；会员人数
menace=vt.&vi.&n.(进行)威胁
mend=vt.改正，修正；改进
merchandise=n.商品，货物
merciful=a.仁慈的，宽大的
mercury=n.汞，水银；水银柱
merit=vt.值得vi.应受赏(罚)
mesh=n.网眼，筛孔，网络
mess=vt.弄脏，弄乱，搞糟
message=n.启示，要旨，教训
metallic=a.金属的  n.金属粒子
metallurgy=n.冶金学，冶金术
metropolitan=a.主要都市的n.大主教
microprocessor=n.微信息处理机
microscopic=a.显微镜的，微观的
microwave=n.微波
mighty=a.强大的；巨大的
migrate=vi.迁移，移居
mild=a.(烟、酒)味淡的
milky=a.牛奶的；乳白色的
millionaire=n.百分富翁，巨富
mingle=vt.使混合vi.混合起来
miniature=n.缩影  a.缩小的
minimize=vt.使减到最小
mint=n.薄荷；薄荷糖
mint=n.造币厂；巨额，富源
mirror=n.反映，借鉴
miser=n.守财奴，吝啬鬼
misery=n.痛苦，悲惨，不幸
misfortune=n.不幸，灾祸，灾难
mishief=n.调皮，捣蛋，胡闹
missionary=n.传教士
mist=n.薄雾  vi.下薄雾
mistress=n.情妇，情人
mitten=n.连指手套；露指手套
mixer=n.混合者，搅拌器
mob=vi.聚众闹事
mobilize=vt.动员  vi.动员起来
mock=n.嘲弄  vt.嘲弄，挖苦
moderately=ad.适度地，适中
modesty=n.谦逊；端庄；羞怯
modification=n.缓和；修改；修饰
modulate=vt.调整，调节(声音)
module=n.模数；模；组件
molecular=a.分子的；克分子的
momentary=a.瞬息间的，片刻的
monarch=n.君主，最高统治者
monk=n.和尚，僧侣，修道士
monopoly=n.垄断，独占，专利
monster=n.怪物；畸形的动植物
monstrous=a.可怕的；极大的
moor=vt.使停泊；使固定
mop=n.墩布，洗碗刷
morality=n.道德，美德，品行
mortgage=n.抵押  vt.抵押
Moslem=n.&a.穆斯林(的)
mosque=n.清真寺
moss=n.苔藓，地衣
motel=n.汽车游客旅馆
motive=a.发动的，运动的
motorway=n.汽车道，快车路
mount=v.装配；固定  n.支架
mountainous=a.多山的；山一般的
move=n.行动，步骤
multiplication=n.增加；繁殖；乘法
multitude=n.大批，大群；大量
municipal=a.市的，市立的
murmur=n.低沉连续的声音
muscular=a.肌肉发达的，强健的
muse=vi.沉思，默想，冥想
mustard=n.芥子，芥末
mute=n.弱音器；闭止音
mystery=n.神秘小说，侦探小说
napkin=n.餐巾(纸)
narration=n.叙述；故事；叙述法
negative=a.负的，阴性的
negligible=a.微不足道的
negotiate=vi.谈判，交涉，议定
neighbouring=a.邻近的，接壤的
nest=vi.筑巢  vt.为…筑巢
net=vt.用网捕；用网覆盖
network=n.网络；广播网
neutron=n.中子
nice=a.细微的，微妙的
nickel=n.镍；镍币
nickname=n.绰号，浑号
nightmare=n.恶梦；经常的恐惧
nominate=vt.提名，推荐；任命
norm=n.标准，规范；平均数
normalization=n.正常化，标准化
northward(s)=ad.向北方  a.向北的
nose=n.突出部分(如船头等)
notable=n.值得注意的；著名的
noted=a.著名的，知名的
notify=vt.通知，告知；报告
notion=n.概念，意念；看法
notorious=a.臭名昭著的
notwithstanding=prep.尽管，虽然
nought=n.无，零
nourish=vt.提供养分，养育
nourishment=n.食物；营养(情况)
novel=a.新的，异常的
novelty=n.新颖；新奇的事物
nucleus=n.原子核；细胞核
number=vt.共计，达…之数
numerical=a.数字的，数值的
nun=n.修女，尼姑
nursery=n.苗圃，养鱼池
nut=n.螺帽，螺母
oar=n.桨；划手  vi.划(行)
oath=n.誓言，誓约，宣誓
obedience=n.服从，顺从；管辖
obedient=n.服从的，顺从的
objective=n.宾格  a.目标的
obligation=n.义务，职责，责任
oblige=vt.使感激；施恩惠于
obscure=a.阴暗的；蒙昧的
observation=n.意见，短评，按语
observe=vi.说，评述，评论
obstinate=a.固执的；顽强的
occurrence=n.事故
offence=n.犯罪，犯规；冒犯
offensive=a.冒犯的；进攻的
offer=vt.呈现出  vi.出现
offset=n.分支，抵销  vt.抵销
offspring=n.儿女，子孙，后代
ohm=n.欧姆
olive=n.橄榄，橄榄树
onward(s)=a.向前(的)，在前面
opaque=a.不透明的；不传导的
operation=n.运算
opium=n.鸦片；麻醉剂
optical=a.光的；光学的
optimism=n.乐观，乐观主义
optimum=n.最适条件，最适度
option=n.选择，取舍
orchard=n.果园
orchestra=n.管弦乐队的全部乐器
ordinarily=ad.通常，大概
orient=n.东方；亚洲，远东
orientation=n.向东；定位；方向
originate=vi.发源  vt.首创
ornament=n.装饰物  vt.装修
ornamental=a.装饰的  n.装饰品
otherwise=ad.另外；在其他方面
ought=v.aux  早应该，本应
outbreak=n.(战争、愤怒等)爆发
outcome=n.后果，成果
outermost=a.最外面的，最远的
outlaw=n.逃犯，歹徒
outlet=n.发泄(感情等)的方法
outline=vt.概述，概括
outside=prep.在…外，向…外
oval=a.卵形的  n.卵形
over=prep.在(做)…时
overall=a.综合的  n.工作服
overestimate=vt.过高估计
overflow=vt.从…中溢出
overhang=vt.悬于…之上vi.悬垂
overhear=vt.偶然听到；偷听
overlap=vt.与…交搭  vi.重迭
overload=vt.使超载
overlook=vt.眺望；看漏；宽容
overseas=ad.在海外，(向)国外
overtake=vt.突然袭击，压倒
overthrow=vt.推翻  n.推翻，瓦解
overwhelm=vt.压倒，使不知所措
overwhelming=a.压倒的，势不可挡的
oxide=n.氧化物
oxidize=vt.氧化，使生锈
oyster=n.牡蛎；沉默寡言的人
pace=vi.(马)溜蹄走
pacific=a.性情温和的
pal=n.好朋友；同谋
pamphlet=n.小册子
panel=n.(选定的)专门小组
panic=n.恐慌，惊慌
pant=vi.气喘
panther=n.豹，黑豹；美洲狮
pantry=n.食品柜，餐具室
pants=n.裤子；男用短衬裤
paper=vt.用纸包装(或覆盖)
parachute=n.降落伞；风散种子
parade=vt.夸耀(才能等)
paragraph=n.小新闻，短评
paralyse=vt.使麻痹，使瘫痪
parameter=n.参(变)数；参量
participant=n.参加者  a.有份的
participate=vi.参与  vt.分享
particular=a.苛求的；特称的
partition=n.分开，分割；融墙
passport=n.达到目的的手段
pasture=n.牧场；牲畜饲养
patent=a.专利的  n.专利
pathetic=a.哀婉动人的；可怜的
patriot=n.爱国者，爱国主义者
patriotic=a.爱国的
patrol=n.巡逻  n.巡逻，巡查
patron=n.庇护人；赞助人
pattern=vt.仿制，仿造，模仿
peacock=n.孔雀
peak=n.(物体的)尖端
peck=vt.&vi.啄，啄起
peculiarity=n.特性，独特性；怪癖
pedal=n.踏脚，踏板，脚蹬
pedestrian=n.行人，步行者
pedlar=n.(挨户兜售的)小贩
peel=n.果皮，蔬菜皮
peer=vi.凝视；隐约出现
penalty=n.处罚，刑罚；罚款
pendulum=n.(钟等的)摆
penetration=n.穿入；渗透，侵入
perception=n.感觉；概念；理解力
perch=n.(禽鸟的)栖木
perfect=vt.使熟练，使改善
perfection=n.尽善尽美；无比精确
peril=n.危机；危险的事物
perimeter=n.周(边)，周长
periodic=n.周期的；一定时期的
periodical=n.期刊，杂志
peripheral=a.周界的；末梢的
perish=vi.死亡，夭折；枯萎
perpendicular=a.垂直的  n.垂直(线)
perpetual=a.永久的；四季开花的
perplex=vt.迷惑，困惑，难住
persecute=vt.迫害，残害
persevere=vi.坚持，不屈不挠
persist=vi.持续，存留
persistence=n.坚持；持续，存留
personality=n.人格，个性；人物
personnel=n.人事部门
persuasion=n.劝说，说服；主张
pertinent=a.恰当的；有关的
pest=n.害虫；害人虫
petition=n.请愿  vt.向…请愿
petty=a.细小的；器量小的
photoelectric=a.光电的
photography=n.摄影术
physically=ad.物质上；体格上
pickle=n.腌制食品，泡菜
pier=n.(桥)墩；码头
pierce=vt.穿透，戳穿，洞察
pilgrim=n.香客，朝圣者
pineapple=n.凤梨，波萝
pious=a.虔诚的；虔奉宗教的
pipe=n.管乐器
pirate=n.海盗；每盗船
piston=n.活塞
pitch=n.人造树脂
plague=n.瘟疫，鼠疫；天灾
plain=a.坦白的；普通的
plastic=a.塑料的；塑性的
plateau=n.高原；平稳时期
platform=n.政纲，党纲，宣言
plea=n.请愿，请求，恳求
plead=vt.为…辩护  vi.抗辩
pledge=n.誓言  vt.使发誓
pluck=vt.鼓起(勇气)，振作
plump=vt.丰满的；鼓起的
plunder=v.&n.掠夺，劫掠
pneumatic=a.空气的；气动的
poke=vt.戳，刺；伸(头等)
polar=a.南(北)极的；极性的
polarity=n.极性；(思想等)归向
politics=n.政纲，政见，策略
poll=n.投票  vi.投票
polymer=n.聚合物，多聚物
ponder=vt.考虑  vi.沉思
pop=vi.(意外地)出现
pope=n.(罗马天主教的)教皇
popularity=n.通俗性；普及，流行
porcelain=n.瓷  a.瓷的，瓷制的
pore=n.毛孔，气孔，细孔
portable=a.可移动的
pose=vt.(使)摆好姿势
position=n.主张，立场；形势
positive=a.正的；阳性的
positively=ad.确定的，断然
possibility=n.可能的事
postal=a.邮政的，邮局的
postulate=vt.要求，假定，假设
poultry=n.家禽
practicable=a.能实行的；适用的
prairie=n.大草原，牧场
preach=vt.说教，布道；鼓吹
precede=vt.先于…  vi.领先
predecessor=n.前辈，前任者
prediction=n.预言，预告；预报
predominant=a.占优势的；主要的
pregnant=a.怀孕的；意义深长的
prejudice=n.偏见，成见；损害
prescription=n.药方，处方的药
presentation=n.介绍；赠送；呈现
preservation=n.保存，储藏；保持
preset=vt.预先装置
preside=vi.主持；主奏
press=n.印刷机，印刷所
pressure=n.电压；大气压力
prestige=n.威望，威信，声望
presumably=ad.推测起来，大概
presume=vt.假定，假设，揣测
prevalent=a.流行的；盛行的
prevention=n.预防，阻止，妨碍
prey=vi.猎物  vi.捕获
prick=vt.刺(穿)  n.刺孔
primitive=a.远古的，未开化的
principally=ad.主要，大抵
printer=n.印刷工；印花工
priority=n.先，前；优先，重点
prism=n.棱柱(体)；棱镜
probe=n.探针  vt.用探针探查
proceeding=n.程序，行动，事项
producer=n.生产者；舞台监督
productive=a.生产的；出产…的
productivity=n.生产率；多产
proficiency=n.熟练，精通
proficient=a.熟练的，精通的
profitable=a.有利的；有益的
profound=a.深刻的；渊博的
program=vi.编制程序
prohibition=n.禁止；禁令，禁律
projector=n.投影仪；探照灯
prolong=vt.延长，拉长，拖延
promotion=n.促进；提升；创立
promptly=ad.敏捷地，迅速地
propaganda=n.宣传；宣传机构
propagate=vt.繁殖；传播，普及
propagation=n.繁殖；传播；蔓延
propel=vt.推进，推动
propeller=n.螺旋桨，推进器
proper=a.合乎体统的，正派的
prophecy=n.预言，预言能力
prophet=n.预言家，先知
proposition=n.命题，主题；提议
propulsion=n.推进，推进力
prose=n.散文
proton=n.质子，氕核
prototype=n.原型；典型，范例
proverb=n.谚语，格言，箴言
province=n.领域，范围，职权
provision=n.规定，条款，条项
provoke=vt.对…挑衅；激发
prudent=a.谨慎的；精明的
psychology=n.心理学；心理
puff=vi.喘气  vt.喷(烟等)
pulley=n.滑轮，滑车，皮带轮
pumpkin=n.南瓜，南瓜藤
punch=vt.冲压  n.冲压机
puppy=n.小狗；幼小的动物
purify=vt.提纯，精炼(金属)
pyjamas=n.(宽大的)睡衣裤
qualification=n.资格；限制条件
qualify=vt.限制，限定，修饰
qualitative=a.质的；定性的
quantify=vt.确定…的数量
quantitative=a.量的；定量的
quarterly=a.季度的  ad.季度地
quartz=n.石英
quench=vt.熄灭，扑灭；压制
quest=vt.寻找  vi.追求
question=vt.问，询问，讯问
questionable=a.可疑的，不可靠的
questionnaire=n.调查表，征求意见表
quiver=vi.(轻微地)颤动
radial=a.光线的；放射的
radiant=a.绚丽的；容光焕发的
radiator=n.暖气片，散热器
radical=a.基本的；激进的
radius=n.半径距离；界限
raise=vt.提出，发起，发出
raisin=n.葡萄干
rally=n.&vt.&vi.(重新)集合
ramble=vi.闲逛，漫步；聊天
ranch=n.(北美洲的)大牧场
random=n.随机  a.随机的
range=vt.排列；把…分类
rap=n.轻敲击声  vt.敲击
rapidity=n.快，迅速；陡，险峻
rapture=n.狂喜，欢天喜地
rascal=n.流氓，恶棍，无赖
rash=a.轻率的；鲁莽的
rate=n.价格  vt.对…评定
rational=a.推理的；适度的
rattle=vt.发出格格声
reactor=n.反应器；反应堆
realistic=a.现实的；现实主义的
realization=n.(理想等的)实现
rear=vt.饲养，培植；抚养
reason=vt.辩论，讨论
rebuke=vt.指责，非难，斥责
receiver=n.接待者；收受者
recipe=n.菜谱，烹饪法；处方
reciprocal=a.相互的；互利的
reckless=a.粗心大意的；鲁莽的
reckon=vi.数，算帐  vt.认为
reclaim=vt.开垦，开拓；回收
recognition=n.认出，识别；重视
recommendation=n.推荐，介绍；建议
reconcile=vt.使和好；调停
recreation=n.消遣，娱乐活动
rectangle=n.矩形，长方形
rectify=vt.纠正；调整；精馏
reed=n.芦笛，牧笛
reef=n.礁，礁石，暗礁
reel=vt.卷，绕
referee=n.(足球等)裁判员
reference=n.参考文献；参照系
refinery=n.精炼厂，提炼厂
refrain=vi.抑制，制止，忍住
refreshment=n.(精力的)恢复，爽快
refugee=n.难民，流亡者
regenerative=a.新生的；回授的
regime=n.政体，政权；制度
regiment=n.团，军团；一大群
regularity=n.规则性；整齐
regulate=vt.调整，调节，对准
regulation=n.规章，规则；调节
reign=n.朝代
reject=vt.舍弃，抛弃；排斥
relay=vt.分程传递；使接替
religion=n.信念，信条
remainder=n.剩余(物)；余数
repay=vt.&vi.偿还，报答
repeal=vt.撤销；放弃  n.撤销
repel=vt.拒绝；使厌恶
replace=vt.送还，归还，赔还
replacement=n.归还；取代；置换
report=n.传说，议论
representation=n.描写；陈述；代表
representative=a.代表性的；代议制的
reproduce=vt.仿造
reproduction=n.再生(产)；繁殖
reptile=n.爬行动物；两栖动物
requisite=a.需要的  n.必需品
resemblance=n.相似，相似性
resent=vt.对…不满，怨恨
reservation=n.保留；预定，预订
reserve=n.缄默，自我克制
reside=vi.居住，驻扎；属于
resident=n.常住者
residual=a.剩余的；残数的
resign=vt.使顺从，使听任于
resignation=n.听从，屈从，顺从
resolute=a.坚决的，果敢的
respectable=a.可敬的；人格高尚的
response=n.回音，回签；灵敏度
responsible=a.重要的；可靠的
restrain=vt.抑制，制止，遏制
resultant=a.作为结果而发生的
resume=n.(谋职者的)个人简历
retail=n.零售  a.零售的
retard=vt.延迟，放慢
retirement=n.退休，引退；退隐
retort=vt.&vi.反击；反驳
reveal=vt.告诉，揭示，泄露
revenue=n.收入；收入数目
reverse=n.背面，反面
revive=vt.&vi.苏醒；复兴
revolve=vt.&vi.(使)旋转
ridicule=vi.&n.嘲弄，挖苦
rigorous=a.(性格等)严峻的
rim=n.边；边缘，(眼镜)框
rinse=vt.涮，嗽；冲洗
riot=n.&vi.骚乱，暴乱
rip=vi.撕啐，扯破，划破
ripple=n.涟漪，细浪，波纹
roam=vt.在…漫步，漫游
roller=n.滚柱，滚筒，辊
Roman=n.罗马人，古罗马人
romance=n.传奇；浪漫文学
romantic=a.好幻想的
rooster=n.公鸡；狂妄自负的人
rotate=vt.&vi.(使)旋转
roundabout=a.迂回的；转弯抹角的
routine=a.日常的  n.常规
row=n.吵嚷，吵架，口角
royalty=n.皇家，王族，皇族
ruby=n.红宝石
rule=n.裁决，裁定
ruthless=a.无情的，冷酷的
safeguard=n.保护措施；护照
salmon=n.鲑，大马哈鱼
salute=vt.迎接，欢迎
sandwich=vt.夹入，挤进
sardine=n.沙丁鱼
satellite=n.附属物
satisfaction=n.快事，乐事；愉快
satisfactorily=ad.圆满地
saturation=n.饱和(状态)；浸透
Saturn=n.农神；土星
scan=n.扫描，扫掠
scandal=n.丑事，丑闻；耻辱
scar=n.瘢痕
scarcity=n.缺乏，不足，萧条
scarlet=n.猩红色  a.猩红的
scheme=vt.计划  vi.搞阴谋
scholarship=n.学问，学识；奖学金
scoff=vt.&vi.嘲笑，嘲弄
scope=n.眼界
scorch=vi.烧焦，枯萎；挖苦
scout=vt.搜索，侦察，跟踪
scramble=vi.&n.爬行，攀登
scrap=n.碎片；废料  vt.废弃
scratch=n.起跑线，起步线
scripture=n.《圣经》；圣书
scrub=n.&vt.擦洗，擦净
sculpture=n.雕刻(术)；雕刻品
seam=n.缝口；接缝；骨缝
seaport=n.海港，港口，港市
seaside=n.海滨(胜地)；海边
second=vt.支持
second-hand=n.旧的，第二手的
section=n.切下的部分
seemingly=ad.表面上，外表上
segment=n.切片，部分；段，节
selection=n.精选的东西；选择
senator=n.参议员；评议员
sensation=n.感觉，知觉；轰动
senseless=a.愚蠢的，无意义的
sensible=a.明显的，感觉得到的
sensitivity=n.敏感(性)；灵敏性
sensor=n.传感器，灵敏元件
sentiment=n.感情；情操；情绪
sequence=n.序列
sermon=n.布道，讲道，说教
serpent=n.蛇(尤指大蛇或毒蛇)
set=n.集(合)
settlement=n.调停；(新)住宅区
severe=a.激烈的；简朴的
shabby=a.褴褛的；破旧的
shade=n.(色彩的)浓淡，深浅
shadowy=a.有影的；幽暗的
shady=a.可疑的，靠不住的
shaft=n.(工具的)柄，杆状物
sham=n.假冒；膺品  vt.假装
shame=vt.使羞愧，玷辱
shameful=a.可耻的；不道德的
shark=n.鲨鱼；贪婪狡猾的人
sharply=ad.严厉地，苛刻地
shatter=vt.粉碎，破碎；毁坏
sheer=a.纯粹的；全然的
shell=n.炮弹，猎枪子弹
sheriff=n.郡长；警察局长
shipbuilding=n.造船(业)，造船学
shipment=n.装货；装载的货物
shipwreck=n.船舶失事
shortage=n.短缺，不足额
shortcut=n.近路，捷径
shorten=vt.弄短，缩小，减少
shorthand=n.速记，速记法
should=v.aux.应该，竟然会
shoulder=vt.承担，挑起，肩负
shove=vt.推  vi.(使劲)推
shovel=n.铲，铁铲  vt.铲
shower=vi.下阵雨  vt.使湿透
shrill=a.尖声的  vt.尖声地叫
shrimp=n.(小)虾，河虾，褐虾
shrine=n.神殿，神龛，圣祠
shrub=n.灌木，灌木丛
shrug=vt.&vi.耸(肩)  n.耸肩
shutter=n.百叶窗；(相机)快门
shuttle=n.(织机的)梭
sideways=ad.斜向一边地
siege=n.包围，围攻，围困
sift=vt.筛，过滤  vi.通过
sight=n.情景，名胜，风景
sign=n.征兆，迹象，病症
significant=a.有效的
signify=vt.表示，意味着
silicon=n.硅(旧名矽)
similarity=n.类似，相似；类似点
simple=a.单纯的；迟钝的
simplicity=n.单纯，质朴
simultaneous=a.同时的，同时存在的
sincerity=n.真诚，诚意；真实
singular=a.异常的，奇异的
sink=n.(厨房内的)洗涤槽
siren=n.汽笛，警报器
sitting-room=n.起居室
situated=a.位于…的
situation=n.(建筑物等的)位置
skeleton=n.骨骼，骷髅；骨架
skip=vi.跳；跳绳；略过
skyscraper=n.摩天楼
slack=a.萧条的；懈怠的
slander=n.&vt.诽谤，诋毁
slang=n.俚语；行话，黑话
slap=vt.掴，拍  n.巴掌，拍
slaughter=vt.&n.屠杀，屠宰
slave=vi.作苦工  vt.奴役
slide=n.滑板，滑座
slim=a.细长的；微小的
slit=vt.切开  n.狭长的切口
slumber=n.睡眠；沉睡状态
smart=vi.刺疼，扎疼，剧痛
smash=vt.打碎，打破，粉碎
smuggle=vt.私运  vi.走私
snack=n.快餐，小吃
snail=n.蜗牛；行动缓慢的人
snap=vt.猛咬，突然折断
sneer=vi.&n.冷笑；嘲笑
sneeze=vi.打喷嚏
sniff=vi.用鼻子吸  vt.嗅
snob=n.势利小人
snobbish=a.势利的，谄上欺下的
snore=vi.打鼾，打呼噜
sociology=n.社会学
sodium=n.钠
sofa=n.长沙发，沙发
soften=vt.使软化  vi.变软弱
softness=n.温和，柔和；软弱
software=n.(计算机的)软件
solar=a.利用太阳光的
solidarity=n.团结；休戚相关
solidify=vt.&vi.团结；凝固
solo=n.独唱，独奏；独唱曲
sophisticated=a.老于世故的；高级的
sorrowful=a.使人伤心的；悲伤的
southwards=ad.向南方
souvenir=n.纪念品，黄豆
sovereign=n.君主  a.统治的
soy=n.酱油；大豆，黄豆
spacious=a.广阔的，广大的
span=n.(桥墩间的)墩距
spatial=a.空间的，占据空间的
specialize=vt.使专门化，专业化
species=n.种，物种；种类
specification=n.载明，详述；规格
specimen=n.抽样，样品
spectacle=n.场面；景象，奇观
spectator=n.参观者，观众
spectrum=n.系列，范围；波谱
speculate=vi.思索，沉思；投机
spherical=a.球形的，球面的
spice=n.香料，调味品；香气
spill=n.(人)摔下，跌下
spiral=a.螺旋(形)的，盘旋的
spite=n.恶意，怨恨
splash=vt.溅泼  vi.泼水  n.溅
split=n.分裂，分化；派系
spokesman=n.发言人，代言人
squash=vt.压碎  n.鲜果汁
squat=vi.&vt.(使)蹲下
squeeze=n.压榨；榨取，佣金
stability=n.坚定
stagger=vi.蹒跚  vt.使摇晃
stainless=a.纯洁的；不锈的
stairway=n.楼梯
stalk=n.主茎，叶柄；高烟囱
stall=n.货摊，书摊；厩
stammer=vt.口吃地说  n.口吃
standardize=vt.使与标准比较
start=vt.开动，着手；开设
stationery=n.文具；信笺
statistics=n.统计，统计数字
steady=a.坚定的，扎实的
steak=n.大块牛肉；牛排
steal=vt.偷偷地做，巧取
stem=n.词干；(手表的)转柄
stereo=n.立体声  a.立体声的
stern=n.艉，船尾；臀部
stew=vt.炖  vi.炖着  n.炖肉
stiff=a.生硬的
stiffness=n.硬度
stillness=n.寂静，无声
sting=n.剧痛；刺激  vt.刺
stitch=n.一针，缝线  vt.缝
stone=n.果核，(水果的)硬核
storage=n.贮藏，保管；仓库
storm=n.爆发  vt.&vi.猛攻
stout=a.矮胖的；坚固的
straighten=vt.把…弄直vi.挺起来
straightforward=a.老实的  ad.坦率地
strait=n.海峡
strange=a.外地的，异乡的
stray=vi.迷路  a.迷路的
streamline=n.流线；流线型
strength=n.兵力；强度
stride=vi.大踏步走  n.大步
strife=n.冲突，竞争
striking=a.显著的，惊人的
strip=n.窄条，长带
strive=vi.努力，奋斗，力求
stroll=n.散步，溜达，闲逛
stubborn=a.顽固的；顽强的
studio=n.工作室；播音室
stuffy=a.不透气的，闷热的
sturdy=a.坚定的；牢固的
subdivide=vt.把…再分
subdue=vt.使屈服，征服
subject=vt.使隶属
subordinate=a.下级的，辅助的
subscribe=vi.订购，认购；预订
subscript=a.写在下方的  n.下标
subscription=n.预约，用户，订阅费
subsequent=a.尔后的
subsequently=ad.其后，其次，接着
subsidiary=a.辅助的，补充的
substance=n.财产；内容，本旨
substantial=a.物质的；坚固的
subtle=a.微妙的；精巧的
succession=n.继承(权)，后裔
successor=n.继承人，继任者
suffice=vi.足够；有能力
suicide=n.&vi.&vt.自杀
suit=vt.使配合vi.彼此协调
suitcase=n.小提箱，衣箱
sullen=a.绷着脸不高兴的
summary=a.概括的；速决的
summit=n.顶点，最高点；极度
summon=vt.召唤；鼓起(勇气)
superb=a.壮丽的；超等的
superficial=a.表面的；肤浅的
superiority=n.优越(性)，优势
supersonic=a.超声的，超声速的
superstition=n.迷信，迷信行为
supervise=vt.&vi.监督，监视
supplement=n.补角
support=vt.经受，承受，忍受
suppress=vt.镇压；抑制；隐瞒
surpass=vt.超过，超越，胜过
surplus=n.过剩，剩余(物资)
survival=n.幸存，残存；幸存者
suspicious=a.可疑的；猜疑的
sweeten=vt.使变甜  vi.变甜
sweetness=n.甜蜜；新鲜；温和
swell=vi.&vt.使膨胀，隆起
switch=n.(树木的)软枝条
symmetrical=a.对称的，匀称的
symmetry=n.对称(性)，匀称
symphony=n.交响乐；交响乐团
symposium=n.酒会；座谈会
symptom=n.症状，征候，征兆
synthesis=n.合成；综合，综合物
systematic=a.成体系的；分类的
systematically=ad.系统地，有规则地
tabulate=vt.把…制成表
tack=n.平头打  vt.钉住
tackle=vt.解决，对付  n.用具
tact=n.机敏，圆滑，得体
tactics=n.策略；战术，兵法
tangle=vt.使缠结，使纠缠
tanker=n.油船；空中加油飞机
tape=vt.系，捆
taper=n.细小的蜡烛；微光
tar=n.柏油，焦油
team=vi.协作，合作
tease=vt.逗乐，戏弄；强求
telex=n.电传，用户电报
tempt=vt.引诱，诱惑，劝诱
tensile=a.张力的；能伸长的
terminal=n.计算机终端；线接头
terminate=vt.&vi.停止，终止
terminology=n.术语学，术语
terrace=n.平台，阳台，露台
terrify=vt.使恐怖，使惊吓
terrorist=n.恐怖分子
testify=v.证明，证实，作证
Thanksgiving=n.感恩节
theatre=n.戏剧效果
theft=n.盗窃，偷窃(行为)
theme=n.题目；词干；主旋律
theorem=n.定理；原理，原则
theory=n.见解，看法，推测
thereafter=ad.此后，以后
therein=ad.在那里，在那时
thereof=ad.它的，其；由此
thermal=a.热的；温泉的
thesis=n.论题，论点；论文
thicken=vt.使变厚(或粗、密)
thigh=n.股，大腿
thorough=a.精心的；详尽的
thoughtless=a.欠考虑的；自私的
thrash=vt.痛打，鞭打  vi.打
thresh=vt.打谷，脱粒；推敲
threshold=n.门槛；入门，开端
thrifty=a.节俭的；兴旺的
thrill=vt.&vi.(使)激动
through=prep.因为，由于
ticket=n.(交通违章)罚款传票
tickle=vt.挠，胳肢；逗乐
tighten=vt.&vi.(使)变紧
tightly=ad.紧地，牢固地
tile=n.瓦片，瓷砖；贴砖
tilt=vt.&vi.(使)倾斜
timely=a.及时的；适时的
tiresome=a.使人厌倦的，讨厌的
toad=n.蟾蜍，癞蛤蟆
token=n.象征；辅币；纪念品
tolerant=a.容忍的；有耐力的
tone=n.色调，光度；风气
torment=n.痛苦  vt.折磨
torpedo=n.鱼雷，水雷
torque=n.转(力)矩，扭(力)矩
toss=vi.翻来复去
tow=vt.&n.拖引，牵引
towards=prep.为了，有助于
tower=vi.高耸，屹立；翱翔
track=vi.留下足迹
trade=vi.做买卖；交换
trader=n.商人；商船
tradesman=n.商人；手艺人
tragic=a.悲剧性的，悲惨的
tramp=vt.&vi.&n.步行，跋涉
trample=vt.&vi.&n.践踏，蹂躏
tranquil=a.平静的；稳定的
transaction=n.处理；交易；和解
transform=vt.变压；变换
transition=n.转变，变迁；过渡
transmission=n.遗传，传染
transplant=vt.&vi.移植，移种
transverse=a.横切的  n.横轴
traverse=vt.横越，横切，横断
tread=vi.&vt.踩，踏，践踏
treasurer=n.司库，财务主管
trench=n.深沟；壕沟，战壕
triangular=a.三角的；三者间的
tribute=n.贡物；献礼，贡献
trifle=vi.玩忽；闲混；嬉耍
trigger=n.扳机  vt.触发，引起
triumphant=a.得胜的；得意洋洋的
trivial=a.琐碎的；平常的
trolley=n.手推车；无轨电车
troop=n.一群，一队，大量
tropic=n.热带地区；回归线
tropical=a.热带的；炎热的
trot=vi.&n.(马)小跑，慢跑
troublesome=a.累赘的，困难的
tuberculosis=n.结核病，肺结核
tug=vi.用力拖  n.猛拉，拖
tulip=n.郁金香
tuna=n.金枪鱼
turtle=n.海龟，玳瑁；甲鱼肉
tutor=vt.教，指导
twilight=n.黎明，黄昏；曙光
twist=v.歪曲，曲解
tyranny=n.暴政，专制；残暴
tyrant=n.暴君；专制君主
ultimate=a.基本的，首要的
ultrasonic=a.超声的  n.超声波
ultraviolet=a.紫外的n.紫外线辐射
unanimous=a.(全体)一致的
uncertain=a.不定的；无常的
underestimate=vt.低估，看轻
underline=vt.着重；预告
undertake=vt.约定，保证；从事
undertaking=n.任务，事业；承担
underwear=n.衫衣，内衣，贴身衣
undesirable=a.不合需要的；讨厌的
uneasy=a.不安的；拘束的
unemployment=n.失业；失业人数
unfit=a.不合适的；无能力的
unfold=vt.展开  vi.呈现
uniformly=ad.相同地；一贯
unique=a.无可匹敌的；极好的
universally=ad.普遍地，一般地
unlimited=a.无限的；不定的
unlock=vt.开…的锁；开启
unpaid=a.未付的；不支薪水的
unreasonable=a.不讲道理的；过度的
untie=vt.解开，松开；解放
uphold=vt.举起；支撑；赞成
uproar=n.骚动，扰乱；喧嚣
uranium=n.铀
urge=vt.&vi.强烈希望
usage=n.习惯法
utensil=n.器皿，用具
utilization=n.利用，效用
vaccinate=vt.给…种牛痘
validity=n.有效，效力；正确
valuable=n.贵重物品，财宝
value=vt.尊重，重视，评价
valve=n.阀，阀门；电子管
vault=n.拱顶；地下室，地窖
vector=n.矢量；飞机航线
veil=vt.以面纱遮掩vi.遮盖
vein=n.静脉，血管，矿脉
velocity=n.迅速，快速
velvet=a.丝绒制的；柔软的
vengeance=n.报复，报仇，复仇
ventilate=vt.使通风，使换气
Venus=n.维纳斯；美人；色情
verge=n.边缘，边界，界限
versatile=a.多方面的；通用的
verse=n.诗，韵文；诗行
version=n.解释
versus=prep.(比赛等中)对
veto=n.否决，否决权，禁止
vicinity=n.邻近；附近地区
vicious=a.邪恶的；恶性的
video=a.录象的
vigorous=a.精力旺盛的，茁壮的
vigour=n.活力，精力；元气
villa=n.别墅；城郊小屋
vine=n.蔓，藤，藤本植物
violate=vt.违犯，违背；侵犯
violation=n.违犯；侵犯，妨碍
violent=a.狂暴的；歪曲的
virgin=n.处女  a.处女的
virtual=a.实际上的，实质上的
visa=n.签证
viscous=a.粘滞的，粘性的
vision=n.视力；眼光，想象力
visit=vt.常去
vital=a.生命的，生机的
vitamin=n.维生素，维他命
vocabulary=n.词汇表，词汇汇编
vocation=n.职业，行业
void=a.空的；无效的
volunteer=n.志愿者  vt.志愿
vow=n.誓言，誓约，许愿
vowel=n.元音；元音字母
vulgar=a.粗俗的，庸俗的
wade=vt.趟(河)，跋涉
wag=vt.摇，摇摆，摆动
waggon=n.敞蓬车厢
waitress=n.女侍者，女服务员
walnut=n.胡桃，核桃树
ward=n.病房，病室；监房
wardrobe=n.衣柜，衣橱，藏衣室
ware=n.商品，货物；物品
warehouse=n.仓库，货栈
warfare=n.战争，战争状态
warning=n.警告，告诫，鉴诫
warrant=n.许可证，委任状
wasp=n.黄蜂，蚂蜂
wasteful=a.浪费的；破坏性的
watchful=a.注意的，警惕的
watertight=a.不漏水的，防水的
watery=a.水的；湿的；乏味的
watt=n.瓦(特)
waver=vi.摇摆；犹豫不决
way=n.状态，状况，规模
weaver=n.织布工，编织者
web=n.网，丝，网状物
wedge=n.楔  vt.楔入；挤入
whale=n.鲸；庞然大物
wharf=n.码头，停泊所
what=a.所…的，尽可能多的
whereas=conj.而，却，反之
whereby=ad.靠什么；靠那个
whilst=conj.同…同时；然而
whisker=n.髯，连鬓胡子
whisper=vt.低声地讲，私下说
white=a.白种(人)的
whitewash=n.石灰水  vt.粉饰
whoever=pron.究竟是谁
wholesome=a.适合卫生的
widely=ad.大大地
wield=vt.挥(剑)；行使
willow=n.柳树，柳木
wind=n.胸口，心窝
winding=n.卷绕着的线a.卷曲的
windmill=n.风车
windy=a.多风的，刮风的
wink=vi.眨眼；使眼色
wisdom=n.(古人的)名言，格言
wither=vi.枯萎  vt.使衰弱
witty=a.机智的；风趣的
woe=n.悲哀，悲痛，苦恼
woodpecker=n.啄木鸟
workpiece=n.工(作)件
workshop=n.专题讨论会
worship=vt.崇拜  vi.做礼拜
wrath=n.暴怒，狂怒，愤慨
wrench=vt.拧，扭伤  n.拧
wrestle=n.摔交；斗争，搏斗
wretched=a.不幸的；卑鄙的
wring=vt.拧，挤，扭，榨
wrinkle=n.皱纹  vt.使起皱纹
xerox=vt.&vi.用静电复印
yacht=n.游艇，快艇
yearn=vi.想念，怀念，向往
yeast=n.酵母
yoke=n.轭，牛轭；枷锁
yolk=n.蛋黄，卵黄
youngster=n.儿童，少年，年轻人
zinc=n.锌  vt.在…上镀锌





    第二卷 第一章
更新时间:2006-7-22 10:22:00 本章字数:22062

?marvel=n.奇迹；惊奇  vt.惊奇
masculine=a.男性的；强壮的
massacre=n.大屠杀，残杀
massive=a.粗大的；大而重的
mast=n.桅杆；杆  vt.扯帆
mature=vt.使成熟  vi.成熟
measurement=n.(量得的)尺寸，大小
mechanics=n.力学，机械学；结构
mechanism=n.机械装置；机制
meditate=vt.沉思，冥想，反省
melancholy=n.&a.忧郁(的)，悲伤
melody=n.旋律，曲调；歌曲
membership=n.成员资格；会员人数
menace=vt.&vi.&n.(进行)威胁
mend=vt.改正，修正；改进
merchandise=n.商品，货物
merciful=a.仁慈的，宽大的
mercury=n.汞，水银；水银柱
merit=vt.值得vi.应受赏(罚)
mesh=n.网眼，筛孔，网络
mess=vt.弄脏，弄乱，搞糟
message=n.启示，要旨，教训
metallic=a.金属的  n.金属粒子
metallurgy=n.冶金学，冶金术
metropolitan=a.主要都市的n.大主教
microprocessor=n.微信息处理机
microscopic=a.显微镜的，微观的
microwave=n.微波
mighty=a.强大的；巨大的
migrate=vi.迁移，移居
mild=a.(烟、酒)味淡的
milky=a.牛奶的；乳白色的
millionaire=n.百分富翁，巨富
mingle=vt.使混合vi.混合起来
miniature=n.缩影  a.缩小的
minimize=vt.使减到最小
mint=n.薄荷；薄荷糖
mint=n.造币厂；巨额，富源
mirror=n.反映，借鉴
miser=n.守财奴，吝啬鬼
misery=n.痛苦，悲惨，不幸
misfortune=n.不幸，灾祸，灾难
mishief=n.调皮，捣蛋，胡闹
missionary=n.传教士
mist=n.薄雾  vi.下薄雾
mistress=n.情妇，情人
mitten=n.连指手套；露指手套
mixer=n.混合者，搅拌器
mob=vi.聚众闹事
mobilize=vt.动员  vi.动员起来
mock=n.嘲弄  vt.嘲弄，挖苦
moderately=ad.适度地，适中
modesty=n.谦逊；端庄；羞怯
modification=n.缓和；修改；修饰
modulate=vt.调整，调节(声音)
module=n.模数；模；组件
molecular=a.分子的；克分子的
momentary=a.瞬息间的，片刻的
monarch=n.君主，最高统治者
monk=n.和尚，僧侣，修道士
monopoly=n.垄断，独占，专利
monster=n.怪物；畸形的动植物
monstrous=a.可怕的；极大的
moor=vt.使停泊；使固定
mop=n.墩布，洗碗刷
morality=n.道德，美德，品行
mortgage=n.抵押  vt.抵押
Moslem=n.&a.穆斯林(的)
mosque=n.清真寺
moss=n.苔藓，地衣
motel=n.汽车游客旅馆
motive=a.发动的，运动的
motorway=n.汽车道，快车路
mount=v.装配；固定  n.支架
mountainous=a.多山的；山一般的
move=n.行动，步骤
multiplication=n.增加；繁殖；乘法
multitude=n.大批，大群；大量
municipal=a.市的，市立的
murmur=n.低沉连续的声音
muscular=a.肌肉发达的，强健的
muse=vi.沉思，默想，冥想
mustard=n.芥子，芥末
mute=n.弱音器；闭止音
mystery=n.神秘小说，侦探小说
napkin=n.餐巾(纸)
narration=n.叙述；故事；叙述法
negative=a.负的，阴性的
negligible=a.微不足道的
negotiate=vi.谈判，交涉，议定
neighbouring=a.邻近的，接壤的
nest=vi.筑巢  vt.为…筑巢
net=vt.用网捕；用网覆盖
network=n.网络；广播网
neutron=n.中子
nice=a.细微的，微妙的
nickel=n.镍；镍币
nickname=n.绰号，浑号
nightmare=n.恶梦；经常的恐惧
nominate=vt.提名，推荐；任命
norm=n.标准，规范；平均数
normalization=n.正常化，标准化
northward(s)=ad.向北方  a.向北的
nose=n.突出部分(如船头等)
notable=n.值得注意的；著名的
noted=a.著名的，知名的
notify=vt.通知，告知；报告
notion=n.概念，意念；看法
notorious=a.臭名昭著的
notwithstanding=prep.尽管，虽然
nought=n.无，零
nourish=vt.提供养分，养育
nourishment=n.食物；营养(情况)
novel=a.新的，异常的
novelty=n.新颖；新奇的事物
nucleus=n.原子核；细胞核
number=vt.共计，达…之数
numerical=a.数字的，数值的
nun=n.修女，尼姑
nursery=n.苗圃，养鱼池
nut=n.螺帽，螺母
oar=n.桨；划手  vi.划(行)
oath=n.誓言，誓约，宣誓
obedience=n.服从，顺从；管辖
obedient=n.服从的，顺从的
objective=n.宾格  a.目标的
obligation=n.义务，职责，责任
oblige=vt.使感激；施恩惠于
obscure=a.阴暗的；蒙昧的
observation=n.意见，短评，按语
observe=vi.说，评述，评论
obstinate=a.固执的；顽强的
occurrence=n.事故
offence=n.犯罪，犯规；冒犯
offensive=a.冒犯的；进攻的
offer=vt.呈现出  vi.出现
offset=n.分支，抵销  vt.抵销
offspring=n.儿女，子孙，后代
ohm=n.欧姆
olive=n.橄榄，橄榄树
onward(s)=a.向前(的)，在前面
opaque=a.不透明的；不传导的
operation=n.运算
opium=n.鸦片；麻醉剂
optical=a.光的；光学的
optimism=n.乐观，乐观主义
optimum=n.最适条件，最适度
option=n.选择，取舍
orchard=n.果园
orchestra=n.管弦乐队的全部乐器
ordinarily=ad.通常，大概
orient=n.东方；亚洲，远东
orientation=n.向东；定位；方向
originate=vi.发源  vt.首创
ornament=n.装饰物  vt.装修
ornamental=a.装饰的  n.装饰品
otherwise=ad.另外；在其他方面
ought=v.aux  早应该，本应
outbreak=n.(战争、愤怒等)爆发
outcome=n.后果，成果
outermost=a.最外面的，最远的
outlaw=n.逃犯，歹徒
outlet=n.发泄(感情等)的方法
outline=vt.概述，概括
outside=prep.在…外，向…外
oval=a.卵形的  n.卵形
over=prep.在(做)…时
overall=a.综合的  n.工作服
overestimate=vt.过高估计
overflow=vt.从…中溢出
overhang=vt.悬于…之上vi.悬垂
overhear=vt.偶然听到；偷听
overlap=vt.与…交搭  vi.重迭
overload=vt.使超载
overlook=vt.眺望；看漏；宽容
overseas=ad.在海外，(向)国外
overtake=vt.突然袭击，压倒
overthrow=vt.推翻  n.推翻，瓦解
overwhelm=vt.压倒，使不知所措
overwhelming=a.压倒的，势不可挡的
oxide=n.氧化物
oxidize=vt.氧化，使生锈
oyster=n.牡蛎；沉默寡言的人
pace=vi.(马)溜蹄走
pacific=a.性情温和的
pal=n.好朋友；同谋
pamphlet=n.小册子
panel=n.(选定的)专门小组
panic=n.恐慌，惊慌
pant=vi.气喘
panther=n.豹，黑豹；美洲狮
pantry=n.食品柜，餐具室
pants=n.裤子；男用短衬裤
paper=vt.用纸包装(或覆盖)
parachute=n.降落伞；风散种子
parade=vt.夸耀(才能等)
paragraph=n.小新闻，短评
paralyse=vt.使麻痹，使瘫痪
parameter=n.参(变)数；参量
participant=n.参加者  a.有份的
participate=vi.参与  vt.分享
particular=a.苛求的；特称的
partition=n.分开，分割；融墙
passport=n.达到目的的手段
pasture=n.牧场；牲畜饲养
patent=a.专利的  n.专利
pathetic=a.哀婉动人的；可怜的
patriot=n.爱国者，爱国主义者
patriotic=a.爱国的
patrol=n.巡逻  n.巡逻，巡查
patron=n.庇护人；赞助人
pattern=vt.仿制，仿造，模仿
peacock=n.孔雀
peak=n.(物体的)尖端
peck=vt.&vi.啄，啄起
peculiarity=n.特性，独特性；怪癖
pedal=n.踏脚，踏板，脚蹬
pedestrian=n.行人，步行者
pedlar=n.(挨户兜售的)小贩
peel=n.果皮，蔬菜皮
peer=vi.凝视；隐约出现
penalty=n.处罚，刑罚；罚款
pendulum=n.(钟等的)摆
penetration=n.穿入；渗透，侵入
perception=n.感觉；概念；理解力
perch=n.(禽鸟的)栖木
perfect=vt.使熟练，使改善
perfection=n.尽善尽美；无比精确
peril=n.危机；危险的事物
perimeter=n.周(边)，周长
periodic=n.周期的；一定时期的
periodical=n.期刊，杂志
peripheral=a.周界的；末梢的
perish=vi.死亡，夭折；枯萎
perpendicular=a.垂直的  n.垂直(线)
perpetual=a.永久的；四季开花的
perplex=vt.迷惑，困惑，难住
persecute=vt.迫害，残害
persevere=vi.坚持，不屈不挠
persist=vi.持续，存留
persistence=n.坚持；持续，存留
personality=n.人格，个性；人物
personnel=n.人事部门
persuasion=n.劝说，说服；主张
pertinent=a.恰当的；有关的
pest=n.害虫；害人虫
petition=n.请愿  vt.向…请愿
petty=a.细小的；器量小的
photoelectric=a.光电的
photography=n.摄影术
physically=ad.物质上；体格上
pickle=n.腌制食品，泡菜
pier=n.(桥)墩；码头
pierce=vt.穿透，戳穿，洞察
pilgrim=n.香客，朝圣者
pineapple=n.凤梨，波萝
pious=a.虔诚的；虔奉宗教的
pipe=n.管乐器
pirate=n.海盗；每盗船
piston=n.活塞
pitch=n.人造树脂
plague=n.瘟疫，鼠疫；天灾
plain=a.坦白的；普通的
plastic=a.塑料的；塑性的
plateau=n.高原；平稳时期
platform=n.政纲，党纲，宣言
plea=n.请愿，请求，恳求
plead=vt.为…辩护  vi.抗辩
pledge=n.誓言  vt.使发誓
pluck=vt.鼓起(勇气)，振作
plump=vt.丰满的；鼓起的
plunder=v.&n.掠夺，劫掠
pneumatic=a.空气的；气动的
poke=vt.戳，刺；伸(头等)
polar=a.南(北)极的；极性的
polarity=n.极性；(思想等)归向
politics=n.政纲，政见，策略
poll=n.投票  vi.投票
polymer=n.聚合物，多聚物
ponder=vt.考虑  vi.沉思
pop=vi.(意外地)出现
pope=n.(罗马天主教的)教皇
popularity=n.通俗性；普及，流行
porcelain=n.瓷  a.瓷的，瓷制的
pore=n.毛孔，气孔，细孔
portable=a.可移动的
pose=vt.(使)摆好姿势
position=n.主张，立场；形势
positive=a.正的；阳性的
positively=ad.确定的，断然
possibility=n.可能的事
postal=a.邮政的，邮局的
postulate=vt.要求，假定，假设
poultry=n.家禽
practicable=a.能实行的；适用的
prairie=n.大草原，牧场
preach=vt.说教，布道；鼓吹
precede=vt.先于…  vi.领先
predecessor=n.前辈，前任者
prediction=n.预言，预告；预报
predominant=a.占优势的；主要的
pregnant=a.怀孕的；意义深长的
prejudice=n.偏见，成见；损害
prescription=n.药方，处方的药
presentation=n.介绍；赠送；呈现
preservation=n.保存，储藏；保持
preset=vt.预先装置
preside=vi.主持；主奏
press=n.印刷机，印刷所
pressure=n.电压；大气压力
prestige=n.威望，威信，声望
presumably=ad.推测起来，大概
presume=vt.假定，假设，揣测
prevalent=a.流行的；盛行的
prevention=n.预防，阻止，妨碍
prey=vi.猎物  vi.捕获
prick=vt.刺(穿)  n.刺孔
primitive=a.远古的，未开化的
principally=ad.主要，大抵
printer=n.印刷工；印花工
priority=n.先，前；优先，重点
prism=n.棱柱(体)；棱镜
probe=n.探针  vt.用探针探查
proceeding=n.程序，行动，事项
producer=n.生产者；舞台监督
productive=a.生产的；出产…的
productivity=n.生产率；多产
proficiency=n.熟练，精通
proficient=a.熟练的，精通的
profitable=a.有利的；有益的
profound=a.深刻的；渊博的
program=vi.编制程序
prohibition=n.禁止；禁令，禁律
projector=n.投影仪；探照灯
prolong=vt.延长，拉长，拖延
promotion=n.促进；提升；创立
promptly=ad.敏捷地，迅速地
propaganda=n.宣传；宣传机构
propagate=vt.繁殖；传播，普及
propagation=n.繁殖；传播；蔓延
propel=vt.推进，推动
propeller=n.螺旋桨，推进器
proper=a.合乎体统的，正派的
prophecy=n.预言，预言能力
prophet=n.预言家，先知
proposition=n.命题，主题；提议
propulsion=n.推进，推进力
prose=n.散文
proton=n.质子，氕核
prototype=n.原型；典型，范例
proverb=n.谚语，格言，箴言
province=n.领域，范围，职权
provision=n.规定，条款，条项
provoke=vt.对…挑衅；激发
prudent=a.谨慎的；精明的
psychology=n.心理学；心理
puff=vi.喘气  vt.喷(烟等)
pulley=n.滑轮，滑车，皮带轮
pumpkin=n.南瓜，南瓜藤
punch=vt.冲压  n.冲压机
puppy=n.小狗；幼小的动物
purify=vt.提纯，精炼(金属)
pyjamas=n.(宽大的)睡衣裤
qualification=n.资格；限制条件
qualify=vt.限制，限定，修饰
qualitative=a.质的；定性的
quantify=vt.确定…的数量
quantitative=a.量的；定量的
quarterly=a.季度的  ad.季度地
quartz=n.石英
quench=vt.熄灭，扑灭；压制
quest=vt.寻找  vi.追求
question=vt.问，询问，讯问
questionable=a.可疑的，不可靠的
questionnaire=n.调查表，征求意见表
quiver=vi.(轻微地)颤动
radial=a.光线的；放射的
radiant=a.绚丽的；容光焕发的
radiator=n.暖气片，散热器
radical=a.基本的；激进的
radius=n.半径距离；界限
raise=vt.提出，发起，发出
raisin=n.葡萄干
rally=n.&vt.&vi.(重新)集合
ramble=vi.闲逛，漫步；聊天
ranch=n.(北美洲的)大牧场
random=n.随机  a.随机的
range=vt.排列；把…分类
rap=n.轻敲击声  vt.敲击
rapidity=n.快，迅速；陡，险峻
rapture=n.狂喜，欢天喜地
rascal=n.流氓，恶棍，无赖
rash=a.轻率的；鲁莽的
rate=n.价格  vt.对…评定
rational=a.推理的；适度的
rattle=vt.发出格格声
reactor=n.反应器；反应堆
realistic=a.现实的；现实主义的
realization=n.(理想等的)实现
rear=vt.饲养，培植；抚养
reason=vt.辩论，讨论
rebuke=vt.指责，非难，斥责
receiver=n.接待者；收受者
recipe=n.菜谱，烹饪法；处方
reciprocal=a.相互的；互利的
reckless=a.粗心大意的；鲁莽的
reckon=vi.数，算帐  vt.认为
reclaim=vt.开垦，开拓；回收
recognition=n.认出，识别；重视
recommendation=n.推荐，介绍；建议
reconcile=vt.使和好；调停
recreation=n.消遣，娱乐活动
rectangle=n.矩形，长方形
rectify=vt.纠正；调整；精馏
reed=n.芦笛，牧笛
reef=n.礁，礁石，暗礁
reel=vt.卷，绕
referee=n.(足球等)裁判员
reference=n.参考文献；参照系
refinery=n.精炼厂，提炼厂
refrain=vi.抑制，制止，忍住
refreshment=n.(精力的)恢复，爽快
refugee=n.难民，流亡者
regenerative=a.新生的；回授的
regime=n.政体，政权；制度
regiment=n.团，军团；一大群
regularity=n.规则性；整齐
regulate=vt.调整，调节，对准
regulation=n.规章，规则；调节
reign=n.朝代
reject=vt.舍弃，抛弃；排斥
relay=vt.分程传递；使接替
religion=n.信念，信条
remainder=n.剩余(物)；余数
repay=vt.&vi.偿还，报答
repeal=vt.撤销；放弃  n.撤销
repel=vt.拒绝；使厌恶
replace=vt.送还，归还，赔还
replacement=n.归还；取代；置换
report=n.传说，议论
representation=n.描写；陈述；代表
representative=a.代表性的；代议制的
reproduce=vt.仿造
reproduction=n.再生(产)；繁殖
reptile=n.爬行动物；两栖动物
requisite=a.需要的  n.必需品
resemblance=n.相似，相似性
resent=vt.对…不满，怨恨
reservation=n.保留；预定，预订
reserve=n.缄默，自我克制
reside=vi.居住，驻扎；属于
resident=n.常住者
residual=a.剩余的；残数的
resign=vt.使顺从，使听任于
resignation=n.听从，屈从，顺从
resolute=a.坚决的，果敢的
respectable=a.可敬的；人格高尚的
response=n.回音，回签；灵敏度
responsible=a.重要的；可靠的
restrain=vt.抑制，制止，遏制
resultant=a.作为结果而发生的
resume=n.(谋职者的)个人简历
retail=n.零售  a.零售的
retard=vt.延迟，放慢
retirement=n.退休，引退；退隐
retort=vt.&vi.反击；反驳
reveal=vt.告诉，揭示，泄露
revenue=n.收入；收入数目
reverse=n.背面，反面
revive=vt.&vi.苏醒；复兴
revolve=vt.&vi.(使)旋转
ridicule=vi.&n.嘲弄，挖苦
rigorous=a.(性格等)严峻的
rim=n.边；边缘，(眼镜)框
rinse=vt.涮，嗽；冲洗
riot=n.&vi.骚乱，暴乱
rip=vi.撕啐，扯破，划破
ripple=n.涟漪，细浪，波纹
roam=vt.在…漫步，漫游
roller=n.滚柱，滚筒，辊
Roman=n.罗马人，古罗马人
romance=n.传奇；浪漫文学
romantic=a.好幻想的
rooster=n.公鸡；狂妄自负的人
rotate=vt.&vi.(使)旋转
roundabout=a.迂回的；转弯抹角的
routine=a.日常的  n.常规
row=n.吵嚷，吵架，口角
royalty=n.皇家，王族，皇族
ruby=n.红宝石
rule=n.裁决，裁定
ruthless=a.无情的，冷酷的
safeguard=n.保护措施；护照
salmon=n.鲑，大马哈鱼
salute=vt.迎接，欢迎
sandwich=vt.夹入，挤进
sardine=n.沙丁鱼
satellite=n.附属物
satisfaction=n.快事，乐事；愉快
satisfactorily=ad.圆满地
saturation=n.饱和(状态)；浸透
Saturn=n.农神；土星
scan=n.扫描，扫掠
scandal=n.丑事，丑闻；耻辱
scar=n.瘢痕
scarcity=n.缺乏，不足，萧条
scarlet=n.猩红色  a.猩红的
scheme=vt.计划  vi.搞阴谋
scholarship=n.学问，学识；奖学金
scoff=vt.&vi.嘲笑，嘲弄
scope=n.眼界
scorch=vi.烧焦，枯萎；挖苦
scout=vt.搜索，侦察，跟踪
scramble=vi.&n.爬行，攀登
scrap=n.碎片；废料  vt.废弃
scratch=n.起跑线，起步线
scripture=n.《圣经》；圣书
scrub=n.&vt.擦洗，擦净
sculpture=n.雕刻(术)；雕刻品
seam=n.缝口；接缝；骨缝
seaport=n.海港，港口，港市
seaside=n.海滨(胜地)；海边
second=vt.支持
second-hand=n.旧的，第二手的
section=n.切下的部分
seemingly=ad.表面上，外表上
segment=n.切片，部分；段，节
selection=n.精选的东西；选择
senator=n.参议员；评议员
sensation=n.感觉，知觉；轰动
senseless=a.愚蠢的，无意义的
sensible=a.明显的，感觉得到的
sensitivity=n.敏感(性)；灵敏性
sensor=n.传感器，灵敏元件
sentiment=n.感情；情操；情绪
sequence=n.序列
sermon=n.布道，讲道，说教
serpent=n.蛇(尤指大蛇或毒蛇)
set=n.集(合)
settlement=n.调停；(新)住宅区
severe=a.激烈的；简朴的
shabby=a.褴褛的；破旧的
shade=n.(色彩的)浓淡，深浅
shadowy=a.有影的；幽暗的
shady=a.可疑的，靠不住的
shaft=n.(工具的)柄，杆状物
sham=n.假冒；膺品  vt.假装
shame=vt.使羞愧，玷辱
shameful=a.可耻的；不道德的
shark=n.鲨鱼；贪婪狡猾的人
sharply=ad.严厉地，苛刻地
shatter=vt.粉碎，破碎；毁坏
sheer=a.纯粹的；全然的
shell=n.炮弹，猎枪子弹
sheriff=n.郡长；警察局长
shipbuilding=n.造船(业)，造船学
shipment=n.装货；装载的货物
shipwreck=n.船舶失事
shortage=n.短缺，不足额
shortcut=n.近路，捷径
shorten=vt.弄短，缩小，减少
shorthand=n.速记，速记法
should=v.aux.应该，竟然会
shoulder=vt.承担，挑起，肩负
shove=vt.推  vi.(使劲)推
shovel=n.铲，铁铲  vt.铲
shower=vi.下阵雨  vt.使湿透
shrill=a.尖声的  vt.尖声地叫
shrimp=n.(小)虾，河虾，褐虾
shrine=n.神殿，神龛，圣祠
shrub=n.灌木，灌木丛
shrug=vt.&vi.耸(肩)  n.耸肩
shutter=n.百叶窗；(相机)快门
shuttle=n.(织机的)梭
sideways=ad.斜向一边地
siege=n.包围，围攻，围困
sift=vt.筛，过滤  vi.通过
sight=n.情景，名胜，风景
sign=n.征兆，迹象，病症
significant=a.有效的
signify=vt.表示，意味着
silicon=n.硅(旧名矽)
similarity=n.类似，相似；类似点
simple=a.单纯的；迟钝的
simplicity=n.单纯，质朴
simultaneous=a.同时的，同时存在的
sincerity=n.真诚，诚意；真实
singular=a.异常的，奇异的
sink=n.(厨房内的)洗涤槽
siren=n.汽笛，警报器
sitting-room=n.起居室
situated=a.位于…的
situation=n.(建筑物等的)位置
skeleton=n.骨骼，骷髅；骨架
skip=vi.跳；跳绳；略过
skyscraper=n.摩天楼
slack=a.萧条的；懈怠的
slander=n.&vt.诽谤，诋毁
slang=n.俚语；行话，黑话
slap=vt.掴，拍  n.巴掌，拍
slaughter=vt.&n.屠杀，屠宰
slave=vi.作苦工  vt.奴役
slide=n.滑板，滑座
slim=a.细长的；微小的
slit=vt.切开  n.狭长的切口
slumber=n.睡眠；沉睡状态
smart=vi.刺疼，扎疼，剧痛
smash=vt.打碎，打破，粉碎
smuggle=vt.私运  vi.走私
snack=n.快餐，小吃
snail=n.蜗牛；行动缓慢的人
snap=vt.猛咬，突然折断
sneer=vi.&n.冷笑；嘲笑
sneeze=vi.打喷嚏
sniff=vi.用鼻子吸  vt.嗅
snob=n.势利小人
snobbish=a.势利的，谄上欺下的
snore=vi.打鼾，打呼噜
sociology=n.社会学
sodium=n.钠
sofa=n.长沙发，沙发
soften=vt.使软化  vi.变软弱
softness=n.温和，柔和；软弱
software=n.(计算机的)软件
solar=a.利用太阳光的
solidarity=n.团结；休戚相关
solidify=vt.&vi.团结；凝固
solo=n.独唱，独奏；独唱曲
sophisticated=a.老于世故的；高级的
sorrowful=a.使人伤心的；悲伤的
southwards=ad.向南方
souvenir=n.纪念品，黄豆
sovereign=n.君主  a.统治的
soy=n.酱油；大豆，黄豆
spacious=a.广阔的，广大的
span=n.(桥墩间的)墩距
spatial=a.空间的，占据空间的
specialize=vt.使专门化，专业化
species=n.种，物种；种类
specification=n.载明，详述；规格
specimen=n.抽样，样品
spectacle=n.场面；景象，奇观
spectator=n.参观者，观众
spectrum=n.系列，范围；波谱
speculate=vi.思索，沉思；投机
spherical=a.球形的，球面的
spice=n.香料，调味品；香气
spill=n.(人)摔下，跌下
spiral=a.螺旋(形)的，盘旋的
spite=n.恶意，怨恨
splash=vt.溅泼  vi.泼水  n.溅
split=n.分裂，分化；派系
spokesman=n.发言人，代言人
squash=vt.压碎  n.鲜果汁
squat=vi.&vt.(使)蹲下
squeeze=n.压榨；榨取，佣金
stability=n.坚定
stagger=vi.蹒跚  vt.使摇晃
stainless=a.纯洁的；不锈的
stairway=n.楼梯
stalk=n.主茎，叶柄；高烟囱
stall=n.货摊，书摊；厩
stammer=vt.口吃地说  n.口吃
standardize=vt.使与标准比较
start=vt.开动，着手；开设
stationery=n.文具；信笺
statistics=n.统计，统计数字
steady=a.坚定的，扎实的
steak=n.大块牛肉；牛排
steal=vt.偷偷地做，巧取
stem=n.词干；(手表的)转柄
stereo=n.立体声  a.立体声的
stern=n.艉，船尾；臀部
stew=vt.炖  vi.炖着  n.炖肉
stiff=a.生硬的
stiffness=n.硬度
stillness=n.寂静，无声
sting=n.剧痛；刺激  vt.刺
stitch=n.一针，缝线  vt.缝
stone=n.果核，(水果的)硬核
storage=n.贮藏，保管；仓库
storm=n.爆发  vt.&vi.猛攻
stout=a.矮胖的；坚固的
straighten=vt.把…弄直vi.挺起来
straightforward=a.老实的  ad.坦率地
strait=n.海峡
strange=a.外地的，异乡的
stray=vi.迷路  a.迷路的
streamline=n.流线；流线型
strength=n.兵力；强度
stride=vi.大踏步走  n.大步
strife=n.冲突，竞争
striking=a.显著的，惊人的
strip=n.窄条，长带
strive=vi.努力，奋斗，力求
stroll=n.散步，溜达，闲逛
stubborn=a.顽固的；顽强的
studio=n.工作室；播音室
stuffy=a.不透气的，闷热的
sturdy=a.坚定的；牢固的
subdivide=vt.把…再分
subdue=vt.使屈服，征服
subject=vt.使隶属
subordinate=a.下级的，辅助的
subscribe=vi.订购，认购；预订
subscript=a.写在下方的  n.下标
subscription=n.预约，用户，订阅费
subsequent=a.尔后的
subsequently=ad.其后，其次，接着
subsidiary=a.辅助的，补充的
substance=n.财产；内容，本旨
substantial=a.物质的；坚固的
subtle=a.微妙的；精巧的
succession=n.继承(权)，后裔
successor=n.继承人，继任者
suffice=vi.足够；有能力
suicide=n.&vi.&vt.自杀
suit=vt.使配合vi.彼此协调
suitcase=n.小提箱，衣箱
sullen=a.绷着脸不高兴的
summary=a.概括的；速决的
summit=n.顶点，最高点；极度
summon=vt.召唤；鼓起(勇气)
superb=a.壮丽的；超等的
superficial=a.表面的；肤浅的
superiority=n.优越(性)，优势
supersonic=a.超声的，超声速的
superstition=n.迷信，迷信行为
supervise=vt.&vi.监督，监视
supplement=n.补角
support=vt.经受，承受，忍受
suppress=vt.镇压；抑制；隐瞒
surpass=vt.超过，超越，胜过
surplus=n.过剩，剩余(物资)
survival=n.幸存，残存；幸存者
suspicious=a.可疑的；猜疑的
sweeten=vt.使变甜  vi.变甜
sweetness=n.甜蜜；新鲜；温和
swell=vi.&vt.使膨胀，隆起
switch=n.(树木的)软枝条
symmetrical=a.对称的，匀称的
symmetry=n.对称(性)，匀称
symphony=n.交响乐；交响乐团
symposium=n.酒会；座谈会
symptom=n.症状，征候，征兆
synthesis=n.合成；综合，综合物
systematic=a.成体系的；分类的
systematically=ad.系统地，有规则地
tabulate=vt.把…制成表
tack=n.平头打  vt.钉住
tackle=vt.解决，对付  n.用具
tact=n.机敏，圆滑，得体
tactics=n.策略；战术，兵法
tangle=vt.使缠结，使纠缠
tanker=n.油船；空中加油飞机
tape=vt.系，捆
taper=n.细小的蜡烛；微光
tar=n.柏油，焦油
team=vi.协作，合作
tease=vt.逗乐，戏弄；强求
telex=n.电传，用户电报
tempt=vt.引诱，诱惑，劝诱
tensile=a.张力的；能伸长的
terminal=n.计算机终端；线接头
terminate=vt.&vi.停止，终止
terminology=n.术语学，术语
terrace=n.平台，阳台，露台
terrify=vt.使恐怖，使惊吓
terrorist=n.恐怖分子
testify=v.证明，证实，作证
Thanksgiving=n.感恩节
theatre=n.戏剧效果
theft=n.盗窃，偷窃(行为)
theme=n.题目；词干；主旋律
theorem=n.定理；原理，原则
theory=n.见解，看法，推测
thereafter=ad.此后，以后
therein=ad.在那里，在那时
thereof=ad.它的，其；由此
thermal=a.热的；温泉的
thesis=n.论题，论点；论文
thicken=vt.使变厚(或粗、密)
thigh=n.股，大腿
thorough=a.精心的；详尽的
thoughtless=a.欠考虑的；自私的
thrash=vt.痛打，鞭打  vi.打
thresh=vt.打谷，脱粒；推敲
threshold=n.门槛；入门，开端
thrifty=a.节俭的；兴旺的
thrill=vt.&vi.(使)激动
through=prep.因为，由于
ticket=n.(交通违章)罚款传票
tickle=vt.挠，胳肢；逗乐
tighten=vt.&vi.(使)变紧
tightly=ad.紧地，牢固地
tile=n.瓦片，瓷砖；贴砖
tilt=vt.&vi.(使)倾斜
timely=a.及时的；适时的
tiresome=a.使人厌倦的，讨厌的
toad=n.蟾蜍，癞蛤蟆
token=n.象征；辅币；纪念品
tolerant=a.容忍的；有耐力的
tone=n.色调，光度；风气
torment=n.痛苦  vt.折磨
torpedo=n.鱼雷，水雷
torque=n.转(力)矩，扭(力)矩
toss=vi.翻来复去
tow=vt.&n.拖引，牵引
towards=prep.为了，有助于
tower=vi.高耸，屹立；翱翔
track=vi.留下足迹
trade=vi.做买卖；交换
trader=n.商人；商船
tradesman=n.商人；手艺人
tragic=a.悲剧性的，悲惨的
tramp=vt.&vi.&n.步行，跋涉
trample=vt.&vi.&n.践踏，蹂躏
tranquil=a.平静的；稳定的
transaction=n.处理；交易；和解
transform=vt.变压；变换
transition=n.转变，变迁；过渡
transmission=n.遗传，传染
transplant=vt.&vi.移植，移种
transverse=a.横切的  n.横轴
traverse=vt.横越，横切，横断
tread=vi.&vt.踩，踏，践踏
treasurer=n.司库，财务主管
trench=n.深沟；壕沟，战壕
triangular=a.三角的；三者间的
tribute=n.贡物；献礼，贡献
trifle=vi.玩忽；闲混；嬉耍
trigger=n.扳机  vt.触发，引起
triumphant=a.得胜的；得意洋洋的
trivial=a.琐碎的；平常的
trolley=n.手推车；无轨电车
troop=n.一群，一队，大量
tropic=n.热带地区；回归线
tropical=a.热带的；炎热的
trot=vi.&n.(马)小跑，慢跑
troublesome=a.累赘的，困难的
tuberculosis=n.结核病，肺结核
tug=vi.用力拖  n.猛拉，拖
tulip=n.郁金香
tuna=n.金枪鱼
turtle=n.海龟，玳瑁；甲鱼肉
tutor=vt.教，指导
twilight=n.黎明，黄昏；曙光
twist=v.歪曲，曲解
tyranny=n.暴政，专制；残暴
tyrant=n.暴君；专制君主
ultimate=a.基本的，首要的
ultrasonic=a.超声的  n.超声波
ultraviolet=a.紫外的n.紫外线辐射
unanimous=a.(全体)一致的
uncertain=a.不定的；无常的
underestimate=vt.低估，看轻
underline=vt.着重；预告
undertake=vt.约定，保证；从事
undertaking=n.任务，事业；承担
underwear=n.衫衣，内衣，贴身衣
undesirable=a.不合需要的；讨厌的
uneasy=a.不安的；拘束的
unemployment=n.失业；失业人数
unfit=a.不合适的；无能力的
unfold=vt.展开  vi.呈现
uniformly=ad.相同地；一贯
unique=a.无可匹敌的；极好的
universally=ad.普遍地，一般地
unlimited=a.无限的；不定的
unlock=vt.开…的锁；开启
unpaid=a.未付的；不支薪水的
unreasonable=a.不讲道理的；过度的
untie=vt.解开，松开；解放
uphold=vt.举起；支撑；赞成
uproar=n.骚动，扰乱；喧嚣
uranium=n.铀
urge=vt.&vi.强烈希望
usage=n.习惯法
utensil=n.器皿，用具
utilization=n.利用，效用
vaccinate=vt.给…种牛痘
validity=n.有效，效力；正确
valuable=n.贵重物品，财宝
value=vt.尊重，重视，评价
valve=n.阀，阀门；电子管
vault=n.拱顶；地下室，地窖
vector=n.矢量；飞机航线
veil=vt.以面纱遮掩vi.遮盖
vein=n.静脉，血管，矿脉
velocity=n.迅速，快速
velvet=a.丝绒制的；柔软的
vengeance=n.报复，报仇，复仇
ventilate=vt.使通风，使换气
Venus=n.维纳斯；美人；色情
verge=n.边缘，边界，界限
versatile=a.多方面的；通用的
verse=n.诗，韵文；诗行
version=n.解释
versus=prep.(比赛等中)对
veto=n.否决，否决权，禁止
vicinity=n.邻近；附近地区
vicious=a.邪恶的；恶性的
video=a.录象的
vigorous=a.精力旺盛的，茁壮的
vigour=n.活力，精力；元气
villa=n.别墅；城郊小屋
vine=n.蔓，藤，藤本植物
violate=vt.违犯，违背；侵犯
violation=n.违犯；侵犯，妨碍
violent=a.狂暴的；歪曲的
virgin=n.处女  a.处女的
virtual=a.实际上的，实质上的
visa=n.签证
viscous=a.粘滞的，粘性的
vision=n.视力；眼光，想象力
visit=vt.常去
vital=a.生命的，生机的
vitamin=n.维生素，维他命
vocabulary=n.词汇表，词汇汇编
vocation=n.职业，行业
void=a.空的；无效的
volunteer=n.志愿者  vt.志愿
vow=n.誓言，誓约，许愿
vowel=n.元音；元音字母
vulgar=a.粗俗的，庸俗的
wade=vt.趟(河)，跋涉
wag=vt.摇，摇摆，摆动
waggon=n.敞蓬车厢
waitress=n.女侍者，女服务员
walnut=n.胡桃，核桃树
ward=n.病房，病室；监房
wardrobe=n.衣柜，衣橱，藏衣室
ware=n.商品，货物；物品
warehouse=n.仓库，货栈
warfare=n.战争，战争状态
warning=n.警告，告诫，鉴诫
warrant=n.许可证，委任状
wasp=n.黄蜂，蚂蜂
wasteful=a.浪费的；破坏性的
watchful=a.注意的，警惕的
watertight=a.不漏水的，防水的
watery=a.水的；湿的；乏味的
watt=n.瓦(特)
waver=vi.摇摆；犹豫不决
way=n.状态，状况，规模
weaver=n.织布工，编织者
web=n.网，丝，网状物
wedge=n.楔  vt.楔入；挤入
whale=n.鲸；庞然大物
wharf=n.码头，停泊所
what=a.所…的，尽可能多的
whereas=conj.而，却，反之
whereby=ad.靠什么；靠那个
whilst=conj.同…同时；然而
whisker=n.髯，连鬓胡子
whisper=vt.低声地讲，私下说
white=a.白种(人)的
whitewash=n.石灰水  vt.粉饰
whoever=pron.究竟是谁
wholesome=a.适合卫生的
widely=ad.大大地
wield=vt.挥(剑)；行使
willow=n.柳树，柳木
wind=n.胸口，心窝
winding=n.卷绕着的线a.卷曲的
windmill=n.风车
windy=a.多风的，刮风的
wink=vi.眨眼；使眼色
wisdom=n.(古人的)名言，格言
wither=vi.枯萎  vt.使衰弱
witty=a.机智的；风趣的
woe=n.悲哀，悲痛，苦恼
woodpecker=n.啄木鸟
workpiece=n.工(作)件
workshop=n.专题讨论会
worship=vt.崇拜  vi.做礼拜
wrath=n.暴怒，狂怒，愤慨
wrench=vt.拧，扭伤  n.拧
wrestle=n.摔交；斗争，搏斗
wretched=a.不幸的；卑鄙的
wring=vt.拧，挤，扭，榨
wrinkle=n.皱纹  vt.使起皱纹
xerox=vt.&vi.用静电复印
yacht=n.游艇，快艇
yearn=vi.想念，怀念，向往
yeast=n.酵母
yoke=n.轭，牛轭；枷锁
yolk=n.蛋黄，卵黄
youngster=n.儿童，少年，年轻人
zinc=n.锌  vt.在…上镀锌








　　